m = consonant bilabial nasal pulmonic voiced
ɱ = consonant labiodental nasal pulmonic voiced
n = consonant alveolar nasal pulmonic voiced
ɳ = consonant retroflex nasal pulmonic voiced
ɲ = consonant palatal nasal pulmonic voiced
ŋ = consonant velar nasal pulmonic voiced
ɴ = consonant uvular nasal pulmonic voiced
p = consonant bilabial plosive pulmonic unvoiced
p̪ = consonant labiodental plosive pulmonic unvoiced
t = consonant alveolar plosive pulmonic unvoiced
ʈ = consonant retroflex plosive pulmonic unvoiced
c = consonant palatal plosive pulmonic unvoiced
k = consonant velar plosive pulmonic unvoiced
q = consonant uvular plosive pulmonic unvoiced
ʡ = consonant pharyngeal plosive pulmonic unvoiced
ʔ = consonant glottal plosive pulmonic unvoiced
b = consonant bilabial plosive pulmonic voiced
b̪ = consonant labiodental plosive pulmonic voiced
d = consonant alveolar plosive pulmonic voiced
ɖ = consonant retroflex plosive pulmonic voiced
ɟ = consonant palatal plosive pulmonic voiced
g = consonant velar plosive pulmonic voiced
ɢ = consonant uvular plosive pulmonic voiced
s = consonant alveolar sibilant pulmonic unvoiced
ʃ = consonant postalveolar sibilant pulmonic unvoiced
ʂ = consonant retroflex sibilant pulmonic unvoiced
ɕ = consonant palatal sibilant pulmonic unvoiced
z = consonant alveolar sibilant pulmonic voiced
ʒ = consonant postalveolar sibilant pulmonic voiced
ʐ = consonant retroflex sibilant pulmonic voiced
ʑ = consonant palatal sibilant pulmonic voiced
ɸ = consonant bilabial nonsibilant-fricative pulmonic unvoiced
f = consonant labiodental nonsibilant-fricative pulmonic unvoiced
θ = consonant dental nonsibilant-fricative pulmonic unvoiced
θ̠ = consonant alveolar nonsibilant-fricative pulmonic unvoiced
ɹ̠̊˔ = consonant postalveolar nonsibilant-fricative pulmonic unvoiced
ç = consonant palatal nonsibilant-fricative pulmonic unvoiced
x = consonant velar nonsibilant-fricative pulmonic unvoiced
χ = consonant uvular nonsibilant-fricative pulmonic unvoiced
ħ = consonant pharyngeal nonsibilant-fricative pulmonic unvoiced
h = consonant glottal nonsibilant-fricative pulmonic unvoiced
β = consonant bilabial nonsibilant-fricative pulmonic unvoiced
v = consonant labiodental nonsibilant-fricative pulmonic unvoiced
ð = consonant dental nonsibilant-fricative pulmonic unvoiced
ð̠= consonant alveolar nonsibilant-fricative pulmonic unvoiced
ɹ̠˔ = consonant postalveolar nonsibilant-fricative pulmonic unvoiced
ɻ˔ = consonant retroflex nonsibilant-fricative pulmonic unvoiced
ʝ = consonant palatal nonsibilant-fricative pulmonic unvoiced
ɣ = consonant velar nonsibilant-fricative pulmonic unvoiced
ʁ = consonant uvular nonsibilant-fricative pulmonic unvoiced
ʕ = consonant pharyngeal nonsibilant-fricative pulmonic unvoiced
ɦ = consonant glottal nonsibilant-fricative pulmonic unvoiced